{
  "PLAYERS": [
    {
      "TYPE": 0,
      "SPAWN": [ 23, 10 ]
    },
    {
      "TYPE": 1,
      "SPAWN": [ 4, 5 ]
    }
  ],
  "MAP": [
    [ -1, -1, -1, -1, -1, -1, -1, -1, -1, -1, -1, -1, -1, -1, -1, -1, -1, -1, -1, -1, -1, -1, -1, -1, -1, -1, -1, -1 ],
    [ -1, -1, -1, -1, -1, -1, -1, -1, -1, -1, -1, -1, -1, -1, -1, -1, -1, -1, -1, -1, -1, -1, -1, -1, -1, -1, -1, -1 ],
    [ -1,  0,  0,  0,  0,  0,  0,  0,  0,  0,  0,  0,  0,  0,  1,  0,  1,  0,  1,  1,  1,  1,  1,  1,  1,  1,  1, -1 ],
    [ -1,  0,  0,  0,  0,  0,  0,  0,  0,  0,  0,  0,  0,  0,  1,  0,  1,  0,  1,  0,  0,  1,  1,  1,  1,  1,  1, -1 ],
    [ -1,  0,  0,  1,  1,  1,  0,  0,  0,  0,  0,  0,  0,  0,  1,  0,  1,  0,  1,  0,  1,  1,  1,  1,  1,  1,  1, -1 ],
    [ -1,  0,  0,  1,  1,  1,  0,  0,  0,  0,  0,  0,  0,  0,  1,  1,  1,  1,  1,  1,  1,  1,  1,  1,  1,  1,  1, -1 ],
    [ -1,  0,  0,  1,  1,  1,  0,  0,  0,  0,  0,  0,  0,  0,  1,  1,  1,  1,  1,  1,  1,  1,  1,  1,  1,  1,  1, -1 ],
    [ -1,  0,  0,  0,  0,  0,  0,  0,  0,  0,  0,  0,  0,  0,  1,  1,  1,  1, -1, -1,  1,  1,  1,  1,  1,  1,  1, -1 ],
    [ -1,  0,  0,  0,  0,  0,  0,  0,  0,  0,  0,  0,  0,  0,  1,  1,  1,  1, -1, -1,  1,  1,  1,  1,  1,  1,  1, -1 ],
    [ -1,  0,  0,  0,  0,  0,  0,  0,  0,  0,  0,  0,  0,  0,  1,  1,  1,  1,  1,  1,  1,  1,  0,  0,  0,  1,  1, -1 ],
    [ -1,  0,  0,  0,  0,  0,  0,  0,  0,  0,  0,  0,  0,  0,  1,  1,  1,  1,  1,  1,  1,  1,  0,  0,  0,  1,  1, -1 ],
    [ -1,  0,  0,  0,  0,  0,  0,  0,  0,  0,  0,  0,  0,  0,  1,  1,  1,  1,  1,  1,  1,  1,  0,  0,  0,  1,  1, -1 ],
    [ -1,  0,  0,  0,  0,  0,  0,  0,  0,  0,  0,  0,  0,  0,  1,  1,  1,  1,  1,  1,  1,  1,  1,  1,  1,  1,  1, -1 ],
    [ -1,  0,  0,  0,  0,  0,  0,  0,  0,  0,  0,  0,  0,  0,  1,  1,  1,  1,  1,  1,  1,  1,  1,  1,  1,  1,  1, -1 ],
    [ -1, -1, -1, -1, -1, -1, -1, -1, -1, -1, -1, -1, -1, -1, -1, -1, -1, -1, -1, -1, -1, -1, -1, -1, -1, -1, -1, -1 ],
    [ -1, -1, -1, -1, -1, -1, -1, -1, -1, -1, -1, -1, -1, -1, -1, -1, -1, -1, -1, -1, -1, -1, -1, -1, -1, -1, -1, -1 ]
  ]
}