{
  "STAGE": [
    {
      "PLAYERS": [
        {
          "TYPE": 0,
          "SPAWN": [ 3, 3 ]
        },
        {
          "TYPE": 1,
          "SPAWN": [ 15, 6 ]
        },
        {
          "TYPE": 0,
          "SPAWN": [ 3, 6 ]
        },
        {
          "TYPE": 1,
          "SPAWN": [ 15, 3 ]
        }
      ],
      "MAP": [
        [ -1, -1, -1, -1, -1, -1, -1, -1, -1, -1, -1, -1, -1, -1, -1, -1, -1, -1, -1 ],
        [ -1, 0, 0, 0, 0, 0, 0, 0, 0, 1, 1, 1, 1, 1, 1, 1, 1, 1, -1 ],
        [ -1, 0, 0, 0, 0, 0, 0, 0, 0, 1, 1, 1, 1, 1, 1, 1, 1, 1, -1 ],
        [ -1, 0, 0, 0, 0, 0, 0, 0, 0, 1, 1, 1, 1, 1, 1, 1, 1, 1, -1 ],
        [ -1, 0, 0, 0, 0, 0, 0, 0, 0, 1, 1, 1, 1, 1, 1, 1, 1, 1, -1 ],
        [ -1, 0, 0, 0, 0, 0, 0, 0, 0, 1, 1, 1, 1, 1, 1, 1, 1, 1, -1 ],
        [ -1, 0, 0, 0, 0, 0, 0, 0, 0, 1, 1, 1, 1, 1, 1, 1, 1, 1, -1 ],
        [ -1, 0, 0, 0, 0, 0, 0, 0, 0, 1, 1, 1, 1, 1, 1, 1, 1, 1, -1 ],
        [ -1, 0, 0, 0, 0, 0, 0, 0, 0, 1, 1, 1, 1, 1, 1, 1, 1, 1, -1 ],
        [ -1, -1, -1, -1, -1, -1, -1, -1, -1, -1, -1, -1, -1, -1, -1, -1, -1, -1, -1 ]
      ]
    },
    {
      "PLAYERS": [
        {
          "TYPE": 0,
          "SPAWN": [ 4, 5 ]
        },
        {
          "TYPE": 1,
          "SPAWN": [ 23, 10 ]
        },
        {
          "TYPE": 0,
          "SPAWN": [ 4, 6 ]
        },
        {
          "TYPE": 1,
          "SPAWN": [ 23, 9 ]
        }
     ],
      "MAP": [
        [ -1, -1, -1, -1, -1, -1, -1, -1, -1, -1, -1, -1, -1, -1, -1, -1, -1, -1, -1, -1, -1, -1, -1, -1, -1, -1, -1, -1 ],
        [ -1, -1, -1, -1, -1, -1, -1, -1, -1, -1, -1, -1, -1, -1, -1, -1, -1, -1, -1, -1, -1, -1, -1, -1, -1, -1, -1, -1 ],
        [ -1, 1, 1, 1, 1, 1, 1, 1, 1, 1, 1, 1, 1, 1, 0, 0, 0, 0, 0, 0, 0, 0, 0, 0, 0, 0, 0, -1 ],
        [ -1, 1, 1, 1, 1, 1, 1, 1, 1, 1, 1, 1, 1, 1, 0, 0, 0, 0, 0, 0, 0, 0, 0, 0, 0, 0, 0, -1 ],
        [ -1, 1, 1, 0, 0, 0, 1, 1, 1, 1, 1, 1, 1, 1, 0, 0, 0, 0, 0, 0, 0, 0, 0, 0, 0, 0, 0, -1 ],
        [ -1, 1, 1, 0, 0, 0, 1, 1, 1, 1, 1, 1, 1, 1, 0, 0, 0, 0, 0, 0, 0, 0, 0, 0, 0, 0, 0, -1 ],
        [ -1, 1, 1, 0, 0, 0, 1, 1, 1, 1, 1, 1, 1, 1, 0, 0, 0, 0, 0, 0, 0, 0, 0, 0, 0, 0, 0, -1 ],
        [ -1, 1, 1, 1, 1, 1, 1, 1, 1, 1, 1, 1, 1, 1, 0, 0, 0, 0, 0, 0, 0, 0, 0, 0, 0, 0, 0, -1 ],
        [ -1, 1, 1, 1, 1, 1, 1, 1, 1, 1, 1, 1, 1, 1, 0, 0, 0, 0, 0, 0, 0, 0, 0, 0, 0, 0, 0, -1 ],
        [ -1, 1, 1, 1, 1, 1, 1, 1, 1, 1, 1, 1, 1, 1, 0, 0, 0, 0, 0, 0, 0, 0, 1, 1, 1, 0, 0, -1 ],
        [ -1, 1, 1, 1, 1, 1, 1, 1, 1, 1, 1, 1, 1, 1, 0, 0, 0, 0, 0, 0, 0, 0, 1, 1, 1, 0, 0, -1 ],
        [ -1, 1, 1, 1, 1, 1, 1, 1, 1, 1, 1, 1, 1, 1, 0, 0, 0, 0, 0, 0, 0, 0, 1, 1, 1, 0, 0, -1 ],
        [ -1, 1, 1, 1, 1, 1, 1, 1, 1, 1, 1, 1, 1, 1, 0, 0, 0, 0, 0, 0, 0, 0, 0, 0, 0, 0, 0, -1 ],
        [ -1, 1, 1, 1, 1, 1, 1, 1, 1, 1, 1, 1, 1, 1, 0, 0, 0, 0, 0, 0, 0, 0, 0, 0, 0, 0, 0, -1 ],
        [ -1, -1, -1, -1, -1, -1, -1, -1, -1, -1, -1, -1, -1, -1, -1, -1, -1, -1, -1, -1, -1, -1, -1, -1, -1, -1, -1, -1 ],
        [ -1, -1, -1, -1, -1, -1, -1, -1, -1, -1, -1, -1, -1, -1, -1, -1, -1, -1, -1, -1, -1, -1, -1, -1, -1, -1, -1, -1 ]
      ]
    },
    {
      "PLAYERS": [
        {
          "TYPE": 0,
          "SPAWN": [ 4, 5 ]
        },
        {
          "TYPE": 1,
          "SPAWN": [ 24, 10 ]
        },
        {
          "TYPE": 0,
          "SPAWN": [ 4, 6 ]
        },
        {
          "TYPE": 1,
          "SPAWN": [ 24, 9 ]
        }
     ],
      "MAP": [
        [ -1, -1, -1, -1, -1, -1, -1, -1, -1, -1, -1, -1, -1, -1, -1, -1, -1, -1, -1, -1, -1, -1, -1, -1, -1, -1, -1 ],
        [ -1, -1, -1, -1, -1, -1, -1, -1, -1, -1, -1, -1, -1, -1, -1, -1, -1, -1, -1, -1, -1, -1, -1, -1, -1, -1, -1 ],
        [ -1,  0,  0,  0,  0,  0,  0,  0,  0,  0,  0,  0,  0,  0,  1,  1,  1,  1,  1,  1,  1,  1,  1,  1,  1,  1, -1 ],
        [ -1, -1,  0, -1,  0, -1,  0, -1,  0, -1,  0, -1,  0, -1,  1, -1,  1, -1,  1, -1,  1, -1,  1, -1,  1, -1, -1 ],
        [ -1,  0,  0,  0,  0,  0,  0,  0,  0,  0,  0,  0,  0,  0,  1,  1,  1,  1,  1,  1,  1,  1,  1,  1,  1,  1, -1 ],
        [ -1, -1,  0, -1,  0, -1,  0, -1,  0, -1,  0, -1,  0, -1,  1, -1,  1, -1,  1, -1,  1, -1,  1, -1,  1, -1, -1 ],
        [ -1,  0,  0,  0,  0,  0,  0,  0,  0,  0,  0,  0,  0,  0,  1,  1,  1,  1,  1,  1,  1,  1,  1,  1,  1,  1, -1 ],
        [ -1, -1,  0, -1,  0, -1,  0, -1,  0, -1,  0, -1,  0, -1,  1, -1,  1, -1,  1, -1,  1, -1,  1, -1,  1, -1, -1 ],
        [ -1,  0,  0,  0,  0,  0,  0,  0,  0,  0,  0,  0,  0,  0,  1,  1,  1,  1,  1,  1,  1,  1,  1,  1,  1,  1, -1 ],
        [ -1, -1,  0, -1,  0, -1,  0, -1,  0, -1,  0, -1,  0, -1,  1, -1,  1, -1,  1, -1,  1, -1,  1, -1,  1, -1, -1 ],
        [ -1,  0,  0,  0,  0,  0,  0,  0,  0,  0,  0,  0,  0,  0,  1,  1,  1,  1,  1,  1,  1,  1,  1,  1,  1,  1, -1 ],
        [ -1, -1,  0, -1,  0, -1,  0, -1,  0, -1,  0, -1,  0, -1,  1, -1,  1, -1,  1, -1,  1, -1,  1, -1,  1, -1, -1 ],
        [ -1,  0,  0,  0,  0,  0,  0,  0,  0,  0,  0,  0,  0,  0,  1,  1,  1,  1,  1,  1,  1,  1,  1,  1,  1,  1, -1 ],
        [ -1, -1,  0, -1,  0, -1,  0, -1,  0, -1,  0, -1,  0, -1,  1, -1,  1, -1,  1, -1,  1, -1,  1, -1,  1, -1, -1 ],
        [ -1,  0,  0,  0,  0,  0,  0,  0,  0,  0,  0,  0,  0,  0,  1,  1,  1,  1,  1,  1,  1,  1,  1,  1,  1,  1, -1 ],
        [ -1, -1, -1, -1, -1, -1, -1, -1, -1, -1, -1, -1, -1, -1, -1, -1, -1, -1, -1, -1, -1, -1, -1, -1, -1, -1, -1 ],
        [ -1, -1, -1, -1, -1, -1, -1, -1, -1, -1, -1, -1, -1, -1, -1, -1, -1, -1, -1, -1, -1, -1, -1, -1, -1, -1, -1 ]
      ]
    },
    {
      "PLAYERS": [
        {
          "TYPE": 0,
          "SPAWN": [ 4, 5 ]
        },
        {
          "TYPE": 1,
          "SPAWN": [ 19, 10 ]
        },
        {
          "TYPE": 0,
          "SPAWN": [ 3, 5 ]
        },
        {
          "TYPE": 1,
          "SPAWN": [ 20, 10 ]
        }
     ],
      "MAP": [
        [ -1, -1, -1, -1, -1, -1, -1, -1, -1, -1, -1, -1, -1, -1, -1, -1, -1, -1, -1, -1, -1, -1, -1, -1 ],
        [ -1, -1, -1, -1, -1, -1, -1, -1, -1, -1, -1, -1, -1, -1, -1, -1, -1, -1, -1, -1, -1, -1, -1, -1 ],
        [ -1, 1, 1, 1, 1, 1, 1, 1, 1, 1, -1, -1, -1, -1, 0, 0, 0, 0, 0, 0, 0, 0, 0, -1 ],
        [ -1, 1, 1, 1, 1, 1, 1, 1, 1, 1, -1, -1, -1, -1, 0, 0, 0, 0, 0, 0, 0, 0, 0, -1 ],
        [ -1, 1, 1, 0, 0, 0, 1, 1, 1, 1, -1, -1, -1, -1, 0, 0, 0, 0, 0, 0, 0, 0, 0, -1 ],
        [ -1, 1, 1, 0, 0, 0, 1, 1, 1, 1, -1, -1, -1, -1, 0, 0, 0, 0, 0, 0, 0, 0, 0, -1 ],
        [ -1, 1, 1, 0, 0, 0, 1, 1, 1, 1, 1, 1, 0, 0, 0, 0, 0, 0, 0, 0, 0, 0, 0, -1 ],
        [ -1, 1, 1, 1, 1, 1, 1, 1, 1, 1, 1, 1, 0, 0, 0, 0, 0, 0, 0, 0, 0, 0, 0, -1 ],
        [ -1, 1, 1, 1, 1, 1, 1, 1, 1, 1, 1, 1, 0, 0, 0, 0, 0, 0, 0, 0, 0, 0, 0, -1 ],
        [ -1, 1, 1, 1, 1, 1, 1, 1, 1, 1, 1, 1, 0, 0, 0, 0, 0, 0, 1, 1, 1, 0, 0, -1 ],
        [ -1, 1, 1, 1, 1, 1, 1, 1, 1, 1, -1, -1, -1, -1, 0, 0, 0, 0, 1, 1, 1, 0, 0, -1 ],
        [ -1, 1, 1, 1, 1, 1, 1, 1, 1, 1, -1, -1, -1, -1, 0, 0, 0, 0, 1, 1, 1, 0, 0, -1 ],
        [ -1, 1, 1, 1, 1, 1, 1, 1, 1, 1, -1, -1, -1, -1, 0, 0, 0, 0, 0, 0, 0, 0, 0, -1 ],
        [ -1, 1, 1, 1, 1, 1, 1, 1, 1, 1, -1, -1, -1, -1, 0, 0, 0, 0, 0, 0, 0, 0, 0, -1 ],
        [ -1, -1, -1, -1, -1, -1, -1, -1, -1, -1, -1, -1, -1, -1, -1, -1, -1, -1, -1, -1, -1, -1, -1, -1 ],
        [ -1, -1, -1, -1, -1, -1, -1, -1, -1, -1, -1, -1, -1, -1, -1, -1, -1, -1, -1, -1, -1, -1, -1, -1 ]
      ]
    }
  ]
}