{
  "STAGE": [
    {
      "PLAYERS": [
        {
          "TYPE": 0,
          "SPAWN": [ 7, 8 ]
        }
     ],
      "MAP": [
        [ -1, -1, -1, -1, -1, -1, -1, -1, -1, -1, -1, -1, -1, -1, -1],
        [ -1, -1, -1, -1, -1, -1, -1, -1, -1, -1, -1, -1, -1, -1, -1],
        [ -1, -1, -1, -1, -1, -1, -1, -1, -1, -1, -1, -1, -1, -1, -1],
        [ -1, -1, -1, -1, -1, -1, -1, -1, -1, -1, -1, -1, -1, -1, -1],
        [ -1, -1, -1,  1,  1,  1,  1,  1,  1,  1,  1,  1, -1, -1, -1],
        [ -1, -1, -1,  1,  1,  1,  1,  1,  1,  1,  1,  1, -1, -1, -1],
        [ -1, -1, -1,  1,  1,  0,  0,  0,  0,  0,  1,  1, -1, -1, -1],
        [ -1, -1, -1,  1,  1,  0,  0,  0,  0,  0,  1,  1, -1, -1, -1],
        [ -1, -1, -1,  1,  1,  0,  0,  0,  0,  0,  1,  1, -1, -1, -1],
        [ -1, -1, -1,  1,  1,  0,  0,  0,  0,  0,  1,  1, -1, -1, -1],
        [ -1, -1, -1,  1,  1,  0,  0,  0,  0,  0,  1,  1, -1, -1, -1],
        [ -1, -1, -1,  1,  1,  1,  1,  1,  1,  1,  1,  1, -1, -1, -1],
        [ -1, -1, -1,  1,  1,  1,  1,  1,  1,  1,  1,  1, -1, -1, -1],
        [ -1, -1, -1, -1, -1, -1, -1, -1, -1, -1, -1, -1, -1, -1, -1],
        [ -1, -1, -1, -1, -1, -1, -1, -1, -1, -1, -1, -1, -1, -1, -1],
        [ -1, -1, -1, -1, -1, -1, -1, -1, -1, -1, -1, -1, -1, -1, -1],
        [ -1, -1, -1, -1, -1, -1, -1, -1, -1, -1, -1, -1, -1, -1, -1],
        [ -1, -1, -1, -1, -1, -1, -1, -1, -1, -1, -1, -1, -1, -1, -1]
      ]
    }
  ]
}