{
  "PLAYER1": {
    "SPAWN_INDEX": {
      "X": 7,
      "Y": 6
    }
  },
  "PLAYER2": {
    "SPAWN_INDEX": {
      "X": 35,
      "Y": 12
    }
  },
  "MAP": [
    [ -1, -1, -1, -1, -1, -1, -1, -1, -1, -1, -1, -1, -1,  1,  1, -1, -1, -1, -1, -1, -1, -1, -1, -1, -1,  0,  0, -1, -1, -1, -1, -1, -1, -1, -1, -1, -1, -1, -1, -1 ],
    [ -1, -1, -1, -1, -1, -1, -1, -1, -1, -1, -1, -1, -1,  1,  1, -1, -1, -1, -1, -1, -1, -1, -1, -1, -1,  0,  0, -1, -1, -1, -1, -1, -1, -1, -1, -1, -1, -1, -1, -1 ],
    [ -1, -1,  0,  0,  0,  0,  0,  0,  0,  0,  0,  0,  0,  0,  0,  0,  0,  0,  0,  0,  1,  1,  0,  1,  0,  1,  1,  1,  1,  1,  1,  1,  1,  1,  1,  1,  1,  1, -1, -1 ],
    [ -1, -1,  0,  0,  0,  0,  0,  0,  0,  0,  0,  0,  0,  0,  0,  0,  0,  0,  0,  0,  1,  1,  0,  1,  0,  1,  0,  0,  1,  1,  1,  1,  1,  1,  1,  1,  1,  1, -1, -1 ],
    [ -1, -1,  0,  0,  1,  1,  1,  0,  0,  0,  0,  0,  0,  0,  0,  0,  0,  0,  0,  0,  1,  1,  0,  1,  0,  1,  0,  1,  1,  1,  1,  1,  1,  1,  1,  1,  1,  1, -1, -1 ],
    [ -1, -1,  0,  0,  1,  1,  1,  0,  0,  0,  0,  0,  0,  0,  0,  0,  0,  0,  0,  0,  1,  1,  1,  1,  1,  1,  1,  1,  1,  1,  1,  1,  1,  1,  1,  1,  1,  1, -1, -1 ],
    [ -1, -1,  0,  0,  1,  1,  1,  0,  0,  0,  0,  0,  0, -1, -1,  0,  0,  0,  0,  0,  1,  1,  1,  1,  1, -1, -1,  1,  1,  1,  1,  1,  1,  1,  1,  1,  1,  1, -1, -1 ],
    [ -1, -1,  0,  0,  0,  0,  0,  0,  0,  0,  0,  0,  0, -1, -1,  0,  0,  0,  0,  0,  1,  1,  1,  1,  1, -1, -1,  1,  1,  1,  1,  1,  1,  1,  1,  1,  1,  1, -1, -1 ],
    [ -1, -1,  0,  0,  0,  0,  0,  0,  0,  0,  0,  0,  0,  0,  0,  0,  0,  0,  0,  0,  1,  1,  1,  1,  1,  1,  1,  1,  1,  1,  1,  1,  1,  1,  1,  1,  1,  1, -1, -1 ],
    [ -1, -1,  0,  0,  0,  0,  0,  0,  0,  0,  0,  0,  0,  0,  0,  0,  0,  0,  0,  0,  1,  1,  1,  1,  1,  1,  1,  1,  1,  1,  1,  1,  1,  1,  1,  1,  1,  1, -1, -1 ],
    [ -1, -1,  0,  0,  0,  0,  0,  0,  0,  0,  0,  0,  0,  0,  0,  0,  0,  0,  0,  0,  1,  1,  1,  1,  1,  1,  1,  1,  1,  1,  1,  1,  1,  0,  0,  0,  1,  1, -1, -1 ],
    [ -1, -1,  0,  0,  0,  0,  0,  0,  0,  0,  0,  0,  0,  0,  0,  0,  0,  0,  0,  0,  1,  1,  1,  1,  1,  1,  1,  1,  1,  1,  1,  1,  1,  0,  0,  0,  1,  1, -1, -1 ],
    [ -1, -1,  0,  0,  0,  0,  0,  0,  0,  0,  0,  0,  0,  0,  0,  0,  0,  0,  0,  0,  1,  1,  1,  1,  1,  1,  1,  1,  1,  1,  1,  1,  1,  0,  0,  0,  1,  1, -1, -1 ],
    [ -1, -1,  0,  0,  0,  0,  0,  0,  0,  0,  0,  0,  0,  0,  0,  0,  0,  0,  0,  0,  1,  1,  1,  1,  1,  1,  1,  1,  1,  1,  1,  1,  1,  1,  1,  1,  1,  1, -1, -1 ],
    [ -1, -1,  0,  0,  0,  0,  0,  0,  0,  0,  0,  0,  0,  0,  0,  0,  0,  0,  0,  0,  1,  1,  1,  1,  1,  1,  1,  1,  1,  1,  1,  1,  1,  1,  1,  1,  1,  1, -1, -1 ],
    [ -1, -1, -1, -1, -1, -1, -1, -1, -1, -1, -1, -1, -1,  1,  1, -1, -1, -1, -1, -1, -1, -1, -1, -1, -1,  0,  0, -1, -1, -1, -1, -1, -1, -1, -1, -1, -1, -1, -1, -1 ],
    [ -1, -1, -1, -1, -1, -1, -1, -1, -1, -1, -1, -1, -1,  1,  1, -1, -1, -1, -1, -1, -1, -1, -1, -1, -1,  0,  0, -1, -1, -1, -1, -1, -1, -1, -1, -1, -1, -1, -1, -1 ]
  ]
}