{
  "PLAYERS": [
    {
      "TYPE": 0,
      "SPAWN": [ 27, 11 ]
    },
    {
      "TYPE": 1,
      "SPAWN": [ 5, 5 ]
    }
  ],
  "MAP": [
    [ -1, -1, -1, -1, -1, -1, -1, -1, -1,  1,  1, -1, -1, -1, -1, -1, -1, -1, -1, -1, -1,  0,  0, -1, -1, -1, -1, -1, -1, -1, -1, -1 ],
    [ -1, -1, -1, -1, -1, -1, -1, -1, -1,  1,  1, -1, -1, -1, -1, -1, -1, -1, -1, -1, -1,  0,  0, -1, -1, -1, -1, -1, -1, -1, -1, -1 ],
    [ -1, -1, -1, -1, -1, -1, -1, -1, -1,  1,  1, -1, -1, -1, -1, -1, -1, -1, -1, -1, -1,  0,  0, -1, -1, -1, -1, -1, -1, -1, -1, -1 ],
    [ -1, -1,  0,  0,  0,  0,  0,  0,  0,  0,  0,  0,  0,  0,  0,  0,  1,  1,  0,  1,  0,  1,  1,  1,  1,  1,  1,  1,  1,  1, -1, -1 ],
    [ -1, -1,  0,  0,  0,  0,  0,  0,  0,  0,  0,  0,  0,  0,  0,  0,  1,  1,  0,  1,  0,  1,  0,  0,  1,  1,  1,  1,  1,  1, -1, -1 ],
    [ -1, -1,  0,  0,  1,  1,  1,  0,  0,  0,  0,  0,  0,  0,  0,  0,  1,  1,  0,  1,  0,  1,  0,  1,  1,  1,  1,  1,  1,  1, -1, -1 ],
    [ -1, -1,  0,  0,  1,  1,  1,  0,  0,  0,  0,  0,  0,  0,  0,  0,  1,  1,  1,  1,  1,  1,  1,  1,  1,  1,  1,  1,  1,  1, -1, -1 ],
    [ -1, -1,  0,  0,  1,  1,  1,  0,  0,  0,  0,  0,  0,  0,  0,  0,  1,  1,  1,  1,  1,  1,  1,  1,  1,  1,  1,  1,  1,  1, -1, -1 ],
    [ -1, -1,  0,  0,  0,  0,  0,  0,  0,  0,  0,  0,  0,  0,  0,  0,  1,  1,  1,  1,  1, -1, -1,  1,  1,  1,  1,  1,  1,  1, -1, -1 ],
    [ -1, -1,  0,  0,  0,  0,  0,  0,  0,  0,  0,  0,  0,  0,  0,  0,  1,  1,  1,  1,  1, -1, -1,  1,  1,  1,  1,  1,  1,  1, -1, -1 ],
    [  0,  0,  0,  0,  0,  0,  0,  0,  0,  0,  0,  0,  0,  0,  0,  0,  1,  1,  1,  1,  1,  1,  1,  1,  1,  0,  0,  0,  1,  1,  1,  1 ],
    [ -1, -1,  0,  0,  0,  0,  0,  0,  0,  0,  0,  0,  0,  0,  0,  0,  1,  1,  1,  1,  1,  1,  1,  1,  1,  0,  0,  0,  1,  1, -1, -1 ],
    [ -1, -1,  0,  0,  0,  0,  0,  0,  0,  0,  0,  0,  0,  0,  0,  0,  1,  1,  1,  1,  1,  1,  1,  1,  1,  0,  0,  0,  1,  1, -1, -1 ],
    [ -1, -1,  0,  0,  0,  0,  0,  0,  0,  0,  0,  0,  0,  0,  0,  0,  1,  1,  1,  1,  1,  1,  1,  1,  1,  1,  1,  1,  1,  1, -1, -1 ],
    [ -1, -1,  0,  0,  0,  0,  0,  0,  0,  0,  0,  0,  0,  0,  0,  0,  1,  1,  1,  1,  1,  1,  1,  1,  1,  1,  1,  1,  1,  1, -1, -1 ],
    [ -1, -1, -1, -1, -1, -1, -1, -1, -1,  1,  1, -1, -1, -1, -1, -1, -1, -1, -1, -1, -1,  0,  0, -1, -1, -1, -1, -1, -1, -1, -1, -1 ],
    [ -1, -1, -1, -1, -1, -1, -1, -1, -1,  1,  1, -1, -1, -1, -1, -1, -1, -1, -1, -1, -1,  0,  0, -1, -1, -1, -1, -1, -1, -1, -1, -1 ],
    [ -1, -1, -1, -1, -1, -1, -1, -1, -1,  1,  1, -1, -1, -1, -1, -1, -1, -1, -1, -1, -1,  0,  0, -1, -1, -1, -1, -1, -1, -1, -1, -1 ]
  ]
}